┌─────┐┌─────┐┌── ──┐┌── ──┐
│     ┆│     ┆│     ┆│     ┆
│     ┆│     ┆│     ┆│     ┆
      ┆                     
│     ┆│     ┆│     ┆│     ┆
│     ┆│     ┆│     ┆│     ┆
└┄┄┄┄┄┘└┄┄┄┄┄┘└┄┄┄┄┄┘└┄┄ ┄┄┘
